000000000000000000-
110000000000000000-
110000000000000000-
010356000000000000-
010101000000000000-
010101035560000000-
010101010010000000-
025402540025511000-
000000000000011000-
000000000000000000


